00000000000000000000
00010001110001000000
00010001010001000000
00011101110001110000
00000000000000000000
00000000000000000000
00000000000000000000
00100000000000000000
00000000000000000000
00110001100100000100
00000100000000000100
00000000001000110010
00000001010000000000
00001001000000100010
00000000000100000100
00000011111101010110
00000000000000000000
00000000010000010000
00000000000100000000
00000000000000000000
00000000000000000000
00010001110001000000
00010001010001000000
00011101110001110000
00000000000000000000
00000000000000000000
00000000000000000000
00100000000000000000
00000000000000000000
00110001100100000100
00000100000000000100
00000000001000110010
00000001010000000000
00001001000000100010
00000000000100000100
00000011111101010110
00000000000000000000
00000000010000010000
00000000000100000000
00000000000000000000
