LEVELDATEI
00000000000000000000
00000000000000000000
00000000000000010000
00000000011000010101
00000000000100000000
00011000010000000001
00000000000000000000
00001010000010000000
00000000000000000001
01000100100010100001
00000000000201010000
00001000000000010000
00010000000000000000
00000100100010000100
00010000000000000000
00000001000000100100
00000100000000000001
01010010100000000010
00000000000000000000
00000110001101001000
00000000000000000000
00000011001101000101
00000001000001010001
00010100011000110111
01000000010101010101
01111100010000010111
00000101010000000100
00001010011011100100
00000100010000000101
01000101110010110111
00010000000101010000
00001001110000010100
01010000010100010000
01010100110110000111
01010101000101010100
00111001010011110101
00010100000101010001
01010011110100001110
00000000000101010000
01001111001101011000
