LEVELDATEI
00000000000000000000
00000000000000000000
00000000000000000000
00000111000000000000
00000000000000000000
00000100000100000010
00000000000000000000
00000100010001000110
00000000000000000000
00000010000000000011
00000000000000000000
00100100000101000000
00000000002000000000
00001010010101000000
00000000000100000000
00100001001010000100
00000000000000000000
00000000000010110100
00000000000000000000
00000000000100000000
00000000000000000000
00010101010000000111
00000101000001000001
00000111011100000111
00000100000001010000
00000100010101010010
00000000000001010001
00010111111011011110
00010101000001010001
00000110100100000011
01000001000100010100
01100101010101010111
00000101001101000000
00111111011101110111
00000101000100010000
01110101011011000100
00010000000000000001
01000000110110110100
00010101010101000000
01000000000100010000
